11111111111111111
1P010000X0C00C0C1
10010X00010000011
10C00010C00000E01
11111111111111111