111111111111111111111111111111
10P100000000000000000000000001
10010C100000111000000C10000001
100111100000000000001110000001
100000000000000011100000111111
100000000000000000000111100C01
100000111100111100000000100001
100000100000000100000110100001
1000001000CC00010000001C100001
100000100000000100000011100001
100000111111111100000000000001
100000000000000000000000000001
111000011111000011111011110001
1000000000000000000C0000000001
101111100000000000000000000001
10000C100000000001010000000001
100000100000C00001010000000001
100000111100000001C10000000001
100000000000000001010000000001
100000000000000001010000000001
100000000000000000000000000001
100000000000000011100000000001
10000000000100001C001000000001
111111100001C00111111000010111
1000000000011111000C101111E001
1C0000000000000000001000000001
111111111111111111111111111111