111111111111111111111111111111
10P100000000000000000000000001
10010C10000011100X000C1000X001
100111100000000000001110000001
10000000000X000011100000111111
1X0000000000000000000111100C01
1000001111X0111100000000100001
100000100000000100000110100001
1000001000CC00010000001C100001
100000100000000100000011100001
100000111111111100X00000000001
1000000000000000000000000X0001
111000011111000011111011110001
1000000000000000000C0000000001
101111100000000000000000000001
10000C10000XXX0001010000000001
10000010000XC00001010000000001
10000011110XXX0001C10000000001
100000000000000001010000000001
100000000000000001010000000001
100000000000000000000000000001
100000000000000011100000000001
10000000000100001C001000000001
11111110X001C0011111100001X111
1000000000011111X00C101111E001
1C0000000000000000001000000001
111111111111111111111111111111